0 0, 0 1, 0 2, 0 3, 0 4, 0 5, 0 6, 0 7, 0 8, 0 9, 0 10, 0 11, 0 12, 0 13, 0 14, 0 15, 0 16, 0 17, 0 18, 0 19,
1 0, 1 1, 1 2, 1 3, 1 4, 1 5, 1 6, 1 7, 1 8, 1 9, 1 10, 1 11, 1 12, 1 13, 1 14, 1 15, 1 16, 1 17, 1 18, 1 19,
2 0, 2 1, 2 2, 2 3, 2 4, 2 5, 2 6, 2 7, 2 8, 2 9, 2 10, 2 11, 2 12, 2 13, 2 14, 2 15, 2 16, 2 17, 2 18, 2 19,
3 16, 3 17, 3 18, 3 19,
4 13, 4 14, 4 15, 4 16, 4 17, 4 18, 4 19,
5 13, 5 14, 5 15, 5 16, 5 17, 5 18, 5 19,
6 16, 6 17, 6 18, 6 19,
7 16, 7 17, 7 18, 7 19,
8 0, 8 1, 8 2, 8 3, 8 4, 8 5, 8 6, 8 7, 8 8, 8 9, 8 10, 8 11, 8 12, 8 13, 8 14, 8 15, 8 16, 8 17, 8 18, 8 19,
9 0, 9 1, 9 2, 9 3, 9 4, 9 5, 9 6, 9 7, 9 8, 9 9, 9 10, 9 11, 9 12, 9 13, 9 14, 9 15, 9 16, 9 17, 9 18, 9 19,